*****   *****       
*   *****      ***  
*   *     *    * *  
*****   *****  *    
    ***** * ******  
    *     *   *  ***
*****   ***** *     
    *****   ***     
