*****   *****       
*   *****      ***  
*   *     0    * *  
*****   *****  *    
    ***** * ******  
    *     *   *  ***
*****   ***** *     
    *****   ***     
