**   **  ***********    ************  ***    ******
**  **   *******  **    **  ********  ****   **  **
** **    **       **    **     **     ** *   **  **
****     *******   **  **      **     ** **  **  **
****     *******   **  **      **     **  *  **  **
** **    **        **  **      **     **  ** **  **
**  **   **         *  *       **     **   * **    
**   **  *******    ****    ********  **   ****  **
**    **********     **     ************    ***  *0
