**   **  ***********    ************  ***    ******
**  **   *******  **    **  ********  ****   **  **
** **    **       **    **     **     ** *   **  **
****     *******   **  **      **     ** **  **  **
****     *******   **  **      **     **  *  **  **
** **    **        **  **      **     **  ** **  **
**  **   **         *  *       **     **   * **   *
**   **  *******    ****    ********  **   ****  **
**    **********     **     ************    ***  *0
