***** *********************** ****  ********
*   * *              *        *  *       *  
*   ***  ******************** ** *  ********
*              *            *  * *  *       
***** ****  **************  **** *  *  *****
    * *  *               *       *  *  *    
*   * *  *  ************** ****  *  *  *****
*   * *     *              *  *  *  *      *
***** ****  ************** *  ****  *****  *
         *               * *            *  *
***** *  ***************** ***** ********  *
*   * *     *                  * *         *
*   * ******** **************  * *   * *****
*   *        * *            *  * *   * *    
*   **** ***** *  ***********  ******* *   *
*      * *     *  *                  * *   *
*****  * *  ***** ***** ******** ***** *****
       * *  *         * *      * *     *    
******** ***** ******** *****  * *  ********
*  *           *            *  * *         *
*  *  ***** ** *  ***** *****  * ********  *
   *     *   * *  *   * *      *        *  *
************** ** *   * *  *   **** *****  *
*  *            * *   * *  *      *     *  *
*  ************** *   ***  *****  **** *****
*                 *        *         *     *
******** ***** *********** *******   * *****
       * *   * *                 *   * *    
*********** ***** ******************** ****0
